v>...>>>.>v.v..v.>.>.>>>..v..v.>.v.vv>.....>>>>v...>>.>..v>.>vv.>.v.>vv..v.v.v.>.v.....v..v>v>.v....vvvv>v.v.v>v.v>vv..>.v...>>>vv.v.v.>>..
v>.>.v....>...v..v.>.>..>.v.>..>vv.....>..>..vv..vvvvvv.>v>.>.>.>vv....>.v.vv...>..v.....v......v>.v..>v.v>..>.>.v.vvvv>..vv.>v>v.v.vv.v.vv
...vv...vv.>.v..v..>.>....v.>..>...v>...v>...vv>......>>vvv>.>v>.>>vvvv>...v..>>.v..v.>vv..........>v>v>...>.>v.>v>.v..>....v..>>>>...vv..>
>>...>.>....vv.v..>>..v...>>...>.v.>vvv...>v..>>v.vv>..>...v..v.v>vv..>vv..>.v..v..>v.v..>........>.v>v..vvv.v...vvv.>..vvv.>>.v..v.....vv.
>v.>.vv>>...>>v...>..>.>.v.v>.v..v.>>.v.>.v..>.v.v.vv>.v.vv>>vv..>..>..>v.v.....>.v..v>>.v.>vv...>.>.>>>.vv>>>>...v.>..vv.v...v......v...v>
.v...v>.>v.v..v.v...v>v.v>vvv>..>..vv.vv>v.v.....vvv....vv>....>.....v>v.>.v>..v...>>v>v....>>v.>.>v..v>.v.v.vv>v.>v.>v..vv..>v.....>..>..v
.vv.>.>>....>v>v.......>..>.>>......v.v..>>...v.>v>..v>.>..>.>>vv>>...>>..v.v.v....v.>..v..>....>.........vvv...>.>.>..v>>v>..v>.v..v>.v>>.
.v>...vv>v.>v...>vv.v.>.>v.v..>.v.>>>..v...>>>.>.v...........>v..>v>v.>vv....vvv.v.v>..>v>.>>..vv.>..v>>v.v......>.>>vv>.v>v.v.>>..>v>>>v.v
.v......v>>>v>v..v.>>v>.v..v>.>>>.v.>>>....v.....v..v..>.>>>v.>v......v....>v.>...v>.v.>.>v..>>.v.>v>v>...>vvvv...>v>..>vv.>....>.v.v.v....
v....>.>v>.>..>...>v..v.>v..vv.>.>v>vv..>vv>>>>>v.v>..>v..>.>...v>v..>>>>.>.v.v..>.>..v.v>...>..>.>>v..>v..>vv>.v>>...>>>.>vv>v...>...>>>>.
>.>v.v.vv>v..vv.v..v>v..v>......>v.>>>.>>>v..v.v.v>..v.vv....v..>v.v>v>.>.>v.v>>.>.v....v.....>v.>v.vv.>......v...v...>...>vvv.......>>.v..
.v..v.v.>>v...v>>...>vv.>.vvv>.v>vv.>vv>.>v.v>>>>>....>v.v>vvv>v.v>.>..>...>..>.vv..v>>.>...v>v..v...v.v>v.>>.>.v>....v.v.v..>>>.vvv>.vv>>>
.vvv>...vv.v>.>>v.>v>>>v>vv........>v..v.>..>...v..v..v..v>...v.>......>>v>>.>v..>>vv>....>.>vvv.vvv...v.>..v.>>.>>.>...>.vv.....v..>v>.v>>
>>>.v.v.v.v>.v>.>.>v.>.>.....>.v>.>..>.>..v.>>v..>...v...>>.....>v.>..vvv..>v..>...vv>..v>.v.v>>v.vv>.>v..>..>>.v>.v..>..v.>v>v.>v..>>>vv.v
.v.....>..>v>>vv...>.v.....vvv>.v>..vv.....>..>.............>..>.v>v>vv.>.>.>.v.>...>>.>>.>.>v..>>v.>...>v...v>.v..vv..>>v>.>..v>.vvv...v.v
v.>v..>v>.>v>v...vv.vvvvv.>.vvv...v..>>v.......>vv.v.vv.v.v.vv>..>>>v>>.v>.>>>.>vv.v>>v.vv..>>.v>.v>.v...v...v..>..v...v>v>.v...v.>>vv.v.>>
v>.v.v.>.>...>v.v..v..vv..vv>.v>.vv..>......>>vv>>..>..>v>.>>v.....vv>.>.>v>..>v.>.>>.....>.v>..v....v....>v.v>....v.>.v.v.vvv>.....>v.>.v.
....>>>v.>>.v.>..v...>.v.>..>.>v.>....>v..v.>....v...>...v....>.v>>v.>>v>vv..v>v....>v...>>v.v>>....>..>.vv.v.vv>v>>>>>.v.>v>v.v..>..>v....
...>>v>v.>>...>..vvvvv>.v.vv.>.v.>>v>..v.vv>v.>vv.....>.vvv>>>v.v..vvvvvvv.>>vvv>v...>..>.v>>v>...vv>..>..>......v..>.v..>v>>.>>>>..v.>>v.v
..vvvv..v.>>.>.>>>.v.v..v.>v.>.v>v.v>..>.v.v.v.>..v>>.>...vvv.v..>...v....v.v>vv>...v.vv>..>vv.v>v>v...>.vv....>.v>...>v...>>>>..>>....vvvv
v..v.>>>>v..>vvvv>.>v.>v...>>..>v>v...v.>......>>>.......vv.vv>..>...v..>vvv.>.>.v>v.v>.v>......>...v.>..>.v.>.>v>..>....vv.>....vvv...v...
.v.v>....>.>..>...v>..v>>..>>.v.v>v.>.>..>.>.v....>v......vvv>..>>.....>.v..v>.v>v..>.v..v..vvv.v>..>.>.v...>..vv.>v.>v>..v>..>...>.>>.vv.>
v.vv>v.vv...>..>..>..>..>vv>v.>..>.>..>v..>>v>.vvvv>v.>v>vv.>v...vv.v.v.v...vv>.>.....vvvv..>v..v..vv.>v>v.v.>..>.v..>.....vv>>.....vv>...v
..v..v.>>.>v..v>..>...v...>v>>.vv>.>>.v..v>...>..>>..vv.>.v.>>..v>vv>..vv>vv>.v>...vv...v.>>.v..v>.v>>.v.....v..vv>>v>>v>...>v...>.....>.>>
..v....>vv>v.vv..........vv..>>.vv......v..vvv..v>>>v.v.>>.v>>..v..>..vv>v..>>>..>......>v>vv>.>>v....v.v>>.v.>....>>..>v>>.>...>..>vv..>v>
>...>.>>>.>.v..>v>>..v.....>>......v>>..v....>.>v>.>v.>>>vv....>v.v...v..>.>.v.v..>vv>.v>>..v.>vv>.>>...v..>vv.v>.>>.....>.v.v..v...v..>v>>
v....v>.>>>vv>..v>>v....>>>..vvv.>.>..vv...v..>>v.>...>>....>>>.>.>.v.v.......>.v..vv>vv...>v.>v>v.v>v.>>v>v>v>.....>.v>..>...>v>v>...>.v.v
v...>.>.....>.v>vv>>.v..vv..v.v.v.vvvvv.v...v>>.v>...v.v....vv....v>v.>v.>v..>..v.v>>..v>vv>vv.v.>>>.>...v.v..>.v>v>v..v>....v>>..vv>.>>.>v
.v>>..v.vvv......vv...v>.>>v....v....v...>>.>v.>...v.v>>..>>.>v..>.v.........vv.>>>>vv.>..vvv...v....>.>v..v.....v.v..v>.v.............vv>v
v..v.vv..>>....v.>...vvvvvv.v>.....>..v.>>>.v.v>..v.>vv..>.....>v.>v.v.v>......v..>>.>v...vvv>.v>v..>>>>v.>...>...v>.>v.>.>>.....vvv....vv.
....>>..>...>v.>>...v..v.>..>vvv>>v.v>>.vv>...v>....>vv>.vv.>v>>>v..>>>..>.>v..>>v.>vv.>......v>>v.vvv.v.v>.v.v...vv>>vv..>....v>....vv..vv
.>vv>.....vv>.v...>>..>>vv.>>v>...>v..>>.v>v....>....v......>v..v>...v.vv.vv..>v.>.v.>>...>.v..v.v.vv..>.>>vv.>>...>.>..>.v>..v>>v.vv.v.vvv
v.vv.v>>vv>vvv..v.......>>....>v..v>..v.v>v>.>v.v..>v>.v>v.v...>...vv...>.>.>>......v...>...v>..>.v>..vvv>.vvv>vv>>>>...v.vv.>.v.v..v.v>.>v
..>>>..>>v.v...>..>..vvv.v.>>.>.>.v.v..vv>>..>>.v.v.......vvv.>.v..>v>........>.v.>v...>..v>v...>.......>>..>v>.....>vv.v>v.v..>>...v....>.
v.>>>>..>..>>>.vv..>.>..vv..vv..v...>v>...v.>v.>.vv>..v>.....>.>v>.vvv.>.>>v.>..v..v.v...vv.>...>..>>>.>..>.v.>.>..v.v..v>>.v...>v>>.>.v..v
>v.v>v>.v>>v>....v.v>v.>.v..>>....v>v.>>>.vv>.vv....>..v>.vv.>.vvv.v..>....v.......vvv.v>v>v..v..v....v>v>v>.v..v.>..>....>>>..>..v.v.>...v
>>...v>vv>>...vv>>..>.vvvvv>.>.vv.>v>.>.>>>v..>>v..>vv.>>>>..>v...v.v>.......>vv>>...v>.v..>>.>.>v>..>>.....>.>..>vv..>.>..>vvv>.vv.vv>v.>.
...>.>v.>>vvv>vv>>...v.>v...vv>.>.>v.>....>...v.>v.vv.>vv>.>.>.>...>...>>>.v......>.....v.vv.....v.>>..>..v...vvv.>...v..vv>v>..v.>..v..>.v
v>v>>..v>v...>.>vv.>...>>v.>vvv..vv>.>v.....v>v.>v..>v...>..>.>.>v.>.....>..>vv>v..>...v.vv>.v>>v.>v....v>.....v......>..>.........>>...>v.
v.>.>>>.>v>.......v..>v>v....>..v....v.>.....vv.>.>.>>>v..>v..>.v.vv>...v>vv.>v.>...>>..>>>>v..>v.....>.>>>v..>.>>v.>>>......v.>.>vv..vv.>.
.v..v>vv..>..>.vv..v>.>..>>...>>v>..v.....v....v..v.>.v....vv>.v>...v>.vv.>..v>..>vvv.v>.>.v>..>.>...>..v>.vv.>.>.v>v>v..>.vv.>.>v..v>.>>>.
v....>>.>.vv..>v>.v.>..v>.>vv..>.>>.vv.>.v...>v.>.>v....v...vv>..>.>.vv>vv..>...v.>.....>.>..v...>>..vv......>v>vv>v>v..>v>>.>v..v...v..>..
>...>.>v>...>v.>vv.v>.>v.....v.>.>...v>v.v....>.v>..>..v.v>.....vv.vv.>...>vv.>..>.v>.v.....>>.>v.vv>>..v>..>...>v>vv.>v>.>..v>v...>>v.v..v
v>>v>>.vv..vv>vvv.>vv.>.v..vvvv.v>v>..v..vvv>.....>..>.>v..>....>.v>v..>>>..vv.v>v..>v.>>>>.>.vv.v..vvv>>.vv...>.>.>....>>v..>.v>..vvvv>..v
v..>>>.vv....v.v........v>>>..>>..v>..v...>..v>v>.>v......v..vv.v...v.v..>vv>>vv>v>.>>v>.>>>>.v>.....vv..v..>v..>..>vv>>.vv....>>.vv>v>....
.>...vvv......vvv....v...>....v.v.>>.v...>>v>...v>v>v>v.>>v>v>vv.>v.>>>...>.>v>v.v..v.vvv..>vvv..v.>>..vv.......>vvv.vv.vv....v.vvv.>v>..>v
..>.vv>...>>.v.v.v.>.>>..v..v.>..>v.v.v..v>>.>.vv>...vv>>vv.....>vv.>>>vv>>>>>.>.v>........vv.v>>..v.v>..v....>>....>....>>....>v..v>v>>vv.
.....v.v..v....>v...v.v>>.>...>.>>v.>..>>.>>...>>>v.v...v>>>..>v.v...vv.vv..>.>.>>>.v>..>>v>v>........>.vv.>.>v..>>>..>>.>v..>...vv.>..>v..
.v...v>..>.>v.v.v>>.v..>v>>v>>vv.>vv.v.v>v.v...>>.>.>.>>.>v.>..>>>v..v>>.......v>...vv.....>.>v.>v>v...v.>...>>>.v....>.>v....>.>..>..>>.v.
>>v>vv.>.v>.>v.vv>....v>>...v.vv..v....vv>.v....v>.>...v>.vv.v.>.v.>>>.vv.v>>..v.>.....>.>.v>vvv>>vv.v...v...v.>.v..>.v..>.>...v.>......>vv
.v..v..>.vv>..>vv..v>>...v>v.>.>..v>vv.v>vv.vvv.v>...v>v>...v...>v>......>.>v>>v..v.v.>v..vv......v.>.>....v.>.v..v>..>..>.vv..v..>>...>.vv
v>.v...>.v..>.>>.v..>v>.v.>v.v.>>>.v>.v>v.vv.v.>.>.>.v..v.v....v..>.v.v..v..>>.>v.>...v....>.vv..vv.v.>.>..vv>..v.v..v.>.>.v>.v.vvvvv..v.v>
...>.vvvv..v.>v...>v.>v.>...>>>.v>.>.>v>...>>>>>>.v.>>.......v>>v..v.vv.vvv.>.vvvv.vv>.>v>..v.>...vv.vvvv>>>v.>..>v.>...v>vvv.v.....v.vvvv.
>..>..v......>.>>...>v.>v....>.v>..>...>.>...>.>.vv.>>.v.>>.>>>>.vv.vv....>..vvvv...v>.>.>>.>>.>>.v..v>.>..>.vv...>....v>v..>.....v>..v>..>
>..>....v.....v..v.....v...v.>..v....v......>v>..v>.....>>>>..vv.v...>>>....v.>>v....v.v.>>...>>.>>...v..>>>.v..>>.>..>.v.>.vv..v..>.v>...>
.v>>.>>..>vvv.v..>v>..>.v.v..>v......v>>.>>v>>>...>..>>v.vvvv.>.....v..vv.v...>vv>>>v.v..v>..>.v>.>...>>....v>.>..>>>>>.v>>>vv..>>....v.v.>
..v.vv...>.vvv..v.>...>v.......>..v>>>>>.v.>......>v.v>..v.>.>.>>>v......>.v>..v.v>.>.v..v>>..>>>v>>.v..>..v.>...v.....>.vv>...v...>...v...
.v>>v>vv>...>..>.v>.v....v>.vv.v...>.>..>v.....>...>>.>...>>v>vvv.v>>..>..v>>v>..>..vv..>..>v...v...v>..>>..v.v.>vvv....v.v>vvv..>>vv...v.v
.>v>..v.>>.vv....v>..>>>>>>.>.>>..v>.v>..>.....v>>v..v..>..v.v>>vvv..>..>.>.>.vvv.>..vvv...vv>>>..>>..v>>>>>vvv.v.>>...>....vv..vv.v>..vvv>
..v..>.v>>...>.>>>.>v>>v.v.>..>>..>>>v.....>.>>>v>.v.>.v....>v.>>v...>v.v.>..>.>.v>vvvv...vvvvv...v..>>.v..v>......>.>>>...v.>.v...>.....vv
vvvv.v...>v....>>>>.....vv>>>>..vvv.v..v.vv....>v.v..vvv.v..>v>>..v...v.v.>v.vv.v.>>vv>..>..v..>>...v>..v>>>.vv.v.vv..v..vv......v>v.>vv...
.v>>>..vv..>..>..v..>>>vv.>.>.v.>>v..........vv.>..>.>>.v.....>v>v.v.....>.v.v..vvvv>>...>>..v.v>v.v.v...v.....>>>..v.vv...>>...v>v.>>>>.v.
..vvv.>...vv..>vvv.v>>.vv>vv.v..vv....>...>v>>.>.>...v>..>.vv...>>...>v.>...v.>v......vv...v>>>.>.>...>v....vvv>..>>>>v>v>vv>vv..>.v>.v>>..
v>.>v......v...>v.>>v.v>>...>v>>..>.>...>..v.>.v..v.>.>v>vv>>.v..v.>...>v..v.....v>v...>vv.>....>v....v..>v.>vv..>>v..>>.v..>>.v>..>v..v>..
v>.vv.....v>>vv.>>...v..>..>>.vv.v..vv.>vvvv...v.vvv>v>>.....>vvv..v>.v.>.......>>vv>...vvv>v>vv..>vvv...>.vv>>.v.>>.v..>>.....v....>.>>..v
>..>.>v.v..>...v..>>..>.v.>v..v.>.v>>.>.>v>vv>.v.>>..vv>v>..>vv.......>......v>.>>>v...>..>.v>.>v.v..v.>v....>.>.v>.v>v>>v.v.v>>>.vv...vvv>
......v.v...>...v.>>.>v..>.>v....>.>>>...v>v...v.vv.vv>.v..v>>.>v..vv...>.vvvv...v.>>>.v>>.v..>.v>v..>..>.>.vv..v>.>.v.v>>>v>.>..>.>..>>>..
v....v.vv..>>>>..vv>>v...v>.>vv.>v>>.>..>.>>>...v..v.v.>v....>>v.vvv.v.>>...v.v>.vv..v.v.v.>.>>....vv>v.>>.>.>.v>.v>>>.....>.v>.>v>...>.>..
...>>..vv.>.v.v....>>..>.v..>v>.v...>...>v>v>v.>.v.vv>v....>v....>>>v..>>..>....>.>>>v.>.>...v..>>>.>vv..v>v....>....>..vvv>v>v.v>v..vv....
>vv>..>.vv.>>.v...>.>.>>.>v..v>vv...>v....v.vv>....v>...v.vv>...>>>.vv...>...v....>.v....>...v.vv..>.>v..>...>>>..>.v.v.v>>...>..>..>..v.>>
..vv>v>v>>>vvv>.vv>>vv..>>v>>..>v.>>.......>vv.v.vv....>v>..>.v>vv>>.vv.>>..vv.v>>>v.>...>....>>v>.......v>>>>.v>>>>>v.>>...>v.>vv.>.vv.>.v
>v>.v.>.>..>>>.v..>.v..>v..vvv.>..v>.>>.....v....vv.>..>.v.vv...v.v>.>.vv.>....>v..v>.v..>..>....>.v..v..>v>.>>..vv...>..v....>>v..>.v>>.v>
.>..>.....>vvv>.>..v>v.v..>vvv....>v>>>...>..>.>vvv..v.vv.>...>>v.....v.v..v>>>.v.>>vv..v.v..v......vv>v.>>.v.>v.>>>>..>v..v>.....v>.>v.v..
vv>.....>v>>v.>.>.>vv....v>..v.>.v.>vv>v......v.>>..>>.v>>>>.v>....v..>..v>.v.....>>.>....v.>...>v>>>>>.v.>.......>>v>...v..>>vv..>..>v.>vv
>>vv>..v.....v.v>vv.>..v>..vv>...>>>....>..v>v...>...vv.>>.>v>v>>..v.>...v...>.vvv.>>.>.v>v>.>>>...>..v.v>.vv>v.>.v..>...v..v..>..v..v.v>v>
v>....v.v>...vv...>v..v>v...>.>vvv....>.v...>>>v...>...v>>.v>v>>v>..>>>v.>..v.v.v>.v.vv>>..v.>.>..>>.v>v.>>>>...v>>.v.v>.>.v...>vv.vvvv.>v.
...vv...v.>.>.vvvv..v>.vv>.v.>.v>.>v>v......v...>v>>v...v>.>..>..>.>.>>>vv..>..>>.>v..>>>.>v>...>>>.>.>>v.v..v>...v>..v..v.>..vv.v.....>.>.
.>..>.>...........>.>.>v.>>>>v>.>v>.vv...v..>v.vv>..vv.>v.>>>..v.vv.....>>.v...>vv>.>>.v..v.....>v.....>vv.>vv...vv.vv>v.v....v......v..>vv
>v>..v>>>v>>vvv.....v..>>>v..>>>v..>>v>vv.>...v>.>>>.v.vv...v...v>>.....v.>vv..>..>>.vv.>..>......v.>....vv.>vv.....>>v...v>>v.vv>>..>.vv..
>.>v>>v..>.v..vv>.>....v..>>v....>...v>vv>.....vv.v...>v>.v>>..vvv......>...v...>v.v..>.>>.v>...>>>.vv.v>v...v.>...v..v.>v..>>v>>v..>...v..
>.>.>vvv>>.v...v..>v..>>.....>v.....>>vv.v>..>v...>v...>.v.v>>.v>......>>v...>..>.>......>.>..>...vvv>vv>.v.v.v>..vvv>.>.......v.v.>>>v>v>.
...v.v.>.v.>.>.v.>.>>v>v..>>..>>.vv..>>.>>.v>v>>.>...>>>.v.vv>..vv>...>>vv....v.>.v...>>..vv>.>..v>v...>..v..>>....>>>v.vv>>v..>.v....>.>.v
>>v.>>.v>>....>..vvv>v>>v..>vv....>.....vv.vvv>........>v.v.vv>>.v..>v.vv>vv.>>...>..>.v>.>.>>.v.v>v>...vv..v.v>..v>.v>....>vv>>....vv>...v
v.v...v.v.vvv>vv>.vvv.vv.>v>v.v....>.....>>..>.vv.>.>..v....v..v.v...vv.vvvvv......>v.vv..v>v>vv.v...v.>...v>>>v.v>v>.>..vvv.>.v.>v.>.>>v..
...>>>>.v..v.>..v.>v.v>..vv.>.>vv.>>.v>.>....v..v...>.>..vv.>..v.>.v>>...>.>...v.>>.>.vv>v>.>.>..>vv.>vv>...>.v.>.v..>>..>..v>vv.v.v.v.....
.>..vv...vvv>.....vvv>.>v.>vv.v..>.>vv.v.v..>>>..>v.v..vv..>..>v.v>>v...>>.>>.v>>v>..>...>>vv>>..v>......v>.>.v.v...v..v.v.v.v...vv..v>..v.
...v......vv>v.vv>>>.v.>.v.v.....v..>>v.>v.vv>v>>....>......v...>>..>....>>vvv.>v..>....>..v>>>>.>>v>v..>>>.>>v>>v....v.>v.vv>.>....v.>...>
..>>>>v>...v.v..vv>...v>>>>.>..v>.........v.>.>...v.>>...>..v>.>...v..vv.v>>.v..>.....>..>vv.v.v.>.>v>..v>>v.v>v>v>.....>vvv.>>>>>>vvv>.v.>
.v..v....v.vv.v.v..vv>..>>v....v.vv...>.>...>>.v.vv....v>.v.v.>>v>....vv>>..v...v....>.>>.>v......>>.v>v..>..v>vv.>..>>>....v..>...vvv.>>v>
..v>.v....v.>.>v>.>.v...vv>>..>.v...>>v.v...>>..vv>.....v.vv.>>>v>.>..v.>>v......vv>>v.>v..v>>..>..>>..>...>vv....v.vv..v>v.vv...>...>.>v>>
>.vvv.......>.>>...v>v..>.>>v..v.vvv..v.v..>..>>vv>.vv>..v..>...v.v....v.v........>v>>>.vv..v.....>.>v.>v.>v.v........>>v>.v>..>.>..>v>v...
....>vv...v.>>...vv>.....v....v>v.>..vv>.v.vv>>..v>v.v.v.v>vv..v..>v>.v....>v>...>v.....>v...v..v.>.>v>....>....v.v..>>v>>v..>>>>v>>>.>>...
.....v>v>.>.v...v.>>..v>>>>vvv.vv...vv>>.>..v..>v>..>..>..>vv>v....>>v..vv>..v>..>.v..>>vv>>v.v>...>>>.vv.>>.>..vvv>>v>..>v..v.>v.>..v.>...
v..>.>v>.v....v>>>.>...v...v.>>>>..vv...>.>>.>>v.>.>v..v>..>v>....>v>.v>>v.v..v>>.v.>...>..>v...>>>....>vv..v>>v.>>...>v.v.>v...>....>.>v..
...v>>.v.v.....v......>v.....vv>>.>.v.v>.>>>.vv>>.vv..>...>....v>..v>>>>.v..v>>>v>.v>>..>.>...>v...vvvv.>.v...>.>v.>v.>..vv.....>>>>..v..v.
..>>.>>..v>..>vv>>.>.v.vv....>v.v.>>>v>v.v>vv>>>vv...vv.>>...>.v.....v.>.>>.>.vv.v.>>v...vv..vvvv.>....v..>>.>>v.>.v>v.>...v.>.vv.v>>...v>v
..vvvv.v..>v.....>..v.>.>>v.v...>>..>.>.vv...v>v..>.>....>.v.v..v>.....vv...v....>....>...>v..vv>vv...v...>.>..>....>.v.>>v.v.>v.v>.vv>>vv>
.v..>vv>>>.v.>v..>v.>>.v.v...>.v..v.v.....>vv.v.>>vv...v>.>.>....vv.>..vvv.>...v>v>>.>...>>>>..v..v..vv...>.>.v..vv>.>v..>..v.....v.>...v.v
>.v...v.vv>>......>>>>v....>v.>vv>.>>.>v>v..v...>>v..>....v.v.....>...>v....vv.v>....>.>..v.vv..v>v>.>v....vv..v..>v........>.v>.v.........
v.>..vv>...>>.v.vv..>.>v>....v..>.vv..>..>>.>..>vv...v..vvvv>....v..>v.v.>.>.v>....v..>>v>>...v.>>v.v..v.v...>v.v>..v..v>.......>.v...v.vv.
v.>v>v>v>>>...v>.>>..v.>vv>.v..>.vv.>>v>v..>>vvv>.v.....>>.>v.v..>....v.>v.>v.....v>.v>>...v>..>..v.v....v..v...>.v..v....>>.>vvv>..>>.vv..
>v>>.>..v....>v.v...>>>v.>.>..v.>.vvv>v..vv.>vvv.v.>>>v>vvv.>>.>.v.......>>.>.>v>..vv>......v.>>>..v>vv..>..>>..v>vv>>vv.vv.vv.v...v...v.>>
.>.v..v.vv>.>.v..........vv...vvv.v.v.>........>....v>v.vvv.v..v>.....vvv>..v...>..>v>v>>v.>v>v..>.>v>v..v.>.v.>v.>..vvv>.>>>>.vv>>..>v>>.v
.....>vvvv..vv.vvv...vvv...vv>vv.v>>>.v>..v>.v...vv.vv>vv>.>vvvv...>vv...vv>.vv>>>..>.>>>.>vv..>...v.>...vv.>>>...v...vv.>vv.>vvv....>v>>.v
v>..>..v>>>v.>>v.vv>v>..vv>.>....>>>......>..>>..v.>..vv.v...v.>.vv.>>.>>.>..v.......>v.v.>.v.v>.v.v>>.v..vv>.vv.>>>v.v>...>...vv..v.>v>.v.
v.vvvvv..v.>.>.v.>..>>>..vv.>>>vv.......vv..v.....v.vv...v.v>.....>>.vv..>.>>.v..>v.v.v>.>>..v.>........>.v>..>v>>>>>>v.>..>..>v>.vv.vvv...
>..v>v.>>v>v.>..>>vvv>..>v>>v>..>.v.>>.vvv>.>vv.>vv.v........v>v.v..>...>v....v...>.v.>...>vv...v..vv........>...>v.v>..v..v>>..v.>>.v.vv>.
..v.v>.v.v.v>v....>.>>>.>.v>>..vvv>v>.v.>vv.>..>.v>v>v.>vv.vv.v.v.vv..v>.vv.vv.vv.>>...vvv.>..>.>v>......v.>.v>vv.>.v..vv>.v>.v>>.....v.>.>
v.v....>>..v...v>v>vvv....>>....>v>vv.vv>v.>>.vv..>.v.>....>>v..>>>vv..>.......>>....vv.>v>v.v.....v.>.>.>v>>>>..>>..v.>...>>>...vv>v>..>v.
.>.>..vv>>>...vvv.v>..>>v>v.v.v>vv..vv>v>>.vv....v>>v....v>>.vv>v...v..>v>v>.>.>.>>>....>.>.>..vv>v.v.>>...>v>..>.>vv.>..vv..>v..>v.v.....v
>v........>>v....v..>v.v..>.vv>..>v.v.v>>>>v>>vvv>.v>v.>.>.v.v.vvv..vv>..>..>v>.v>..>v.v...>.>.v>..>vvv.....v......>>>.>.v>.>vvv..v>.>v>vv>
..v.>>>>.>v.>>>.....>v>.>..vv..>>v..v.>.....>vv...>>..v..v.v..v>.>..>vv.>...v.v....v.>v.>.>...vvv.vv>.....v.....>.v>.v>.>..>....vv.>v.v....
.v>>.......v.v.v..>>..>v..>vv....>vvvvv.>.>..>...vv.>>v..vv....>v>.>>.>.vvv.>.v....vv>v.vv.>vv......>.>>>>.>.>vvv>vv.v.v..>.v..>..>.......>
.vv..>>..>....vv.vv..>.>.....>>.>.>..vv...>v>.vv>..>v.v>.>...>..v.vv..>.>v>>...>v..v...v...v>.>>>>..>.>>v....>.v..v.v.....>>v.....v.vv....v
..vv>vv...v.>>>v....v>.vv..v>v.>.v>.>v>>.>.v..>.vv...>.v.>.>.v..v.>..v.>>>..>..vv.>..>..>v>..>.>v...v>...>>>....>v...v.vv.>>.vv.>vv>v>>>.>>
>..vv>>vvv..>vvv..v>v.>...>..v>>vv.>v..>.v>.>.>.>v.>vvv>>.>.......v...>>v..>...vvvv>>v>.v..>>vvvvv.v..v>.>..>v....>..v>...>vv>>v.>vvv>...>.
v.v..>..>v...v..>>>v..v>.vvv....>v.v...v.v.>...vv.>v>.v>...>vv>vv.v>vv.v.v..vvv>..>>v.v>v>..>.>v..v..>vv>v.......>.>.v.>..vv.v.v>>.>.>...vv
...>>>v..>v..>>v.>.vvv.v.>>..>..vv>v.......>v.>.>....>v.vv.>..v>...v..>..v>...v>v.....v..v.>>>>>.>.>vv..>vv>vvv.>>>>..>.>v.v.v.>>>.v...>v>.
..vvv..>vv>.vv>v>.>>.>v.>vvv......>..>v...v.v.>.v..>vv>.vv.vvv>.......>.>...v>v.>v..v.>v.>v>vv...v>.>v.>v.v.....v.>>>v.>.v.v>.v..v>.vv....>
>v..v.v..v>>.>..>>...v.>.>......>..>.v.vvvv>vv>v..v>vvvv.>v..v>.....>..>>>...>.v..vv>v>.>..>v..v..v>>.....>.>>>...v>......>.vv..vvv>>......
.>>.v........vv.>.>.v>....v......v.>.>>..>v.v..>....>>.>.....>vv..>.>>.>v.vv..vv....>>..v.vv.>..>.>...>vv..v....>>>...>.v..v..v.>>...v>v...
>v..v.>>>>>....v...>..vv>.>.>>..>vv>vv.>>..>.>..v.vv>v.>>.>..v..v..>>vv.v>...v>v>v..>.>v.vvv...>>.v..>.>>.>>.....>.v>.>v.vv..vvv>......>v>.
....>.>>>>v>>.v>>...v..>>>.vv..v>>..>>.v.v>.v.v.>...v.>>...>v..v....vv.v.....v....>......>.....vv.>.vvvvv>....>vv..>>>v>vv>>v.....>>...v...
.>.....>v>...>v.>>..>v.>v>....vv..v>>..>.vv.v...v>..>..vv.v>..v..>v...>>v..v..v>v.v>.>v>v....v>.v>.vv..v....v.>>..>v..vv.v..>v>>.>>>..vvv.>
>v>>>v...>.>>vvv....v>vv...>...>v..>...>.>....v.v..>>..v>..vv>>>.........>v.v...>v......>>.>vv.......>.>.>..>..>>v>v.v..vv...>>v..>v>.>vv>>
..>v>v>v.vvv.v>.v>>>..>>v>....>.v.>...v>...>v.vv.vv>v..>.>v>vv.v.v.>...vv...v>>>>>vvv.>.v>.vv...>v....v.>...v..>..v..v.v...v>v.v.>v.>v..v..
.v.v.v.v>>.>.>.>>..v.v..v..v.v.>.>.>v>>.v....>>>....>>v>..>v....v......vv.>>..>...>...>>>.>.>>..v.>..>....>..v..vv.vvv>vvv...>>v>>.vv>v>v..
..>.v.>v.>>>>>>....vvv.v>.v.vv.>..v>v.........vv>.>v.v>v.vvv....>v>vv.>>..............v.v>>>..v>..>.>..vv....>.v>...>...v.....>>.vv>.v>..vv
.v...v.>.>.>>vv..>v>.>..>..vv>.>v...v>v.v..>v>.>>...v>v>...v...>..v>>........>v.>..v>..vv.v>v.>.vv>>.>vvv>v.>>>>>.v.v........>>>>..>.vv>v.v
>..v>v...>........v..>.>......v..v.>v.vv>>>>.>.>v.v>..>v.>>>vv....>....>v..>.>.>.v.vvv..>vv>..>v.......v>>>..vv..v..>v>>>...>v.>v.v>...vv>>
>.>....vv.vv.vv.vvv...v>>..>..>.>v.v>>.v.>v.v..>..>....>v..>>>>v.>..v..>>>v.v..v>>....v....v..>>>.>.v.>..>v..>...v...>v..v.>.v......v>.v.v.
.v.v..>....v..>v>vv.v>v>.v>.vvv......>.v..v.v.....>>.v...>..>..vv.>>.>.v..>....>.v>vv>..v>...>.>>vv>.vvvv.v.v>...>....>...>v.v...vvvv>....>
......v>v.vv..>v...vv..v>v....>.>v.>....>....>.>.>.>>...>>.v.>.>.>>v.v>.vv.v>>..>.>.v..>..>.v.....v.v.vv>.vvv....v.>..>.v.......v>.>..vv.v.
>>>...>.>vv>>>>>.>..........>vv>>...v....v.....v>vv.vv>..v>>..v...v>v.....vv>...vv.v..>.v..vv.v>.v.v.>.vvv.vv.>.>...>v>v..>.v>...>v...v.>.v
..>vv.....v.>.>>....vv........vv..>v..v.>.>.....>v>v>>.v.v.>>..v..vv.>v.>vv>v.>.>.vvv.>vv..v.vv.>.>>v....v..v.....v.v>v...v.>.vvv..v..>.>>.
v>vv>>v>.....v..v>v>v...v..>v..v>>.>v.vv>v>>.>..v.v...v>...>v.v.vv.>.v>v>.v...v.>vv>..>..>v.....v.>>...v>vvv>vv....>.v..>v....>..v>>v.>.>.>
.>.>.>.>>.>v.>.v.v..v.v..>v>>..v...>....v>v...v.v..v>.v...v>>v>>.vv...>>.>>>.>...v>vv>....>>..v.>v.v..>.....>>..>>>....v.>>..v..v.v.>..vv..

